IU5-11|IU5-11
StudentID|int32|8|NSP|String|80|Math|int32|5|NachGem|int32|5|Prog|int32|5|Pract|int32|5|
1|Ахмадуллин Тимур Линарович        |Хор	|Хор	|Удов	|Удов
2|Ашуров Георгий Витальевич         |Отл	|Отл	|Отл	|Отл
3|Гапеева Олеся Радиковна           |Отл	|Отл	|Отл	|Отл
4|Изибаев Андрей Андреевич          |Хор	|Хор	|Отл	|Отл
5|Койбаев Тамерлан Николаевич       |Отл	|Отл	|Отл	|Отл
6|Коломийчук Илья Валерьевич        |Отл	|Отл	|Отл	|Хор
7|Корецкий Константин Владимирович  |Хор	|Отл	|Отл	|Отл
8|Котова Анастасия Андреевна        |Хор	|Отл	|Хор	|Хор
9|Курзанова Анастасия Игоревна      |Хор	|Хор	|Отл	|Отл
10|Макридин Денис Дмитриевич        |Удов	|Хор	|Удов	|Удов
11|Михалёв Ярослав Михайлович       |Хор	|Хор	|Отл	|Отл
12|Оразов Алексей Витальевич        |Отл	|Отл	|Отл	|Отл
13|Садиров Фуад Этибар оглы         |Хор	|Хор	|Отл	|Хор
14|Саркисян Стелла Зограбовна       |Хор	|Отл	|Отл	|Отл
15|Сигал Денис Эдуардович           |Удов	|Хор	|Хор	|Хор
16|Слепченкова Светлана Дмитриевна  |Отл	|Отл	|Отл	|Хор
17|Строганов Георгий Константинович |Хор	|Хор	|Отл	|Отл
18|Толстолуцкий Денис Александрович |Отл	|Хор	|Отл	|Хор
19|Успенский Даниил Андреевич       |Хор	|Хор	|Отл	|Хор
20|Хохлов Арсений Сергеевич         |Удов	|Хор	|Отл	|Отл